2222222222222222222222222222222222222222222
2000000000000000000000000000000000222220002
2000000000000000000000000000000000222200002
2000000000000000000000000000000000220000002
2000000000001111000000000000000000200000002
2000011110000000000000005000001100000000002
2110000000000000000000011111112000001000002
2220000111110000000000000222200000012000002
2000000000000000000000000000000000122000002
2001114444444111000000000000001000000000002
2012221133311220000000000000112000000000112
2000222211122200000000000001220000000000002
2000000000000000011111111112200000011110002
2000000000000000000022222222000000000000002
2111111111111111000002222000011111000000002
2222222222222222100000000000000222000000002
2222222222222222210000000000000000000000002
2222222222222222221444444444444444444441112
2222222222222222222133333333333333333312222
2222222222222222222211333333333333333122222
2222222222222222222222111111111111111222222