2222222222222222222222222222222222222222222
2000000000000000000000000000000000000000002
2000000000000000000000000000000000000011112
2000000000000000000000000000000000000000002
2000000000000000100000000000000000000000002
2000000000000000000000016666662000000000002
2000000100000000000000022222222000000000002
2000000000000100000000000000000000000000002
2000000000000000000000000000000000000000002
2011666666666666666110000000111011000000002
2002226666666662222000000000200022100000112
2000222222222220010000000001200002216610002
2000000000000000026666666662000000222220002
2000000000000000002222222220000000000000002
2000000001666666610002222000166661100010002
2050000000222222200000000000022222000026662
2111100000000000000000000000000000000026662
2222211111110000000001100110011001100022222
2222222222221111111666666666666666666122222
2222222222222222222222222666666666622222222
2222222222222222222222222222222222222222222