2222222222222222222222222222222222222222222
2000000000000000005000000000000000000000002
2000000000000000000000000000000000000011112
2000000000000000000000000000000000000000002
2000000000000000000000000000000000000000002
2000000000000000000000000016661000000000002
2000000000000000000000000002222000000000002
2000000000111100000000000000000000000000002
2000000000000000000000000000000000000000002
2011666666666666666111100000110011000000002
2002226666666662222000000000200022100000112
2000222222222220020000000001200002216610002
2100000000000000026666666662000000222220002
2000000000000000002222222220000000000000002
2000000001666666610002222000166661100010002
2000000000222222200000222100022222000026602
2111100000020000000000000000000000000026602
2222211110000000000001100110011001100022202
2222222221111111111666666666666666666122202
2222222222222222222222222666666666611000052
2222222222222222222222222222222222222222222