2222222222222222222222222222222222222222222
2000000000000000000000000000002000000005002
2000000000000000000000000000002000000011112
2000000000000000000000000000002000000000002
2000000000000000000000000000002000000000002
2000000000000000000000010000002000001000002
2000000000000000000000021111112000002000002
2000000111110000000000002222220000012000112
2000000000000000000000000000000000122000002
2011666666666111000000000000100000000000002
2002226666622220000000000000200000000000112
2000222222222200010000000000210000000000002
2000000000000000026666666666220000011110002
2000000000000000002222222222000000000000002
2000000001666666610002222000016611100000002
2000000000111111100000000000002222000001002
2111100000000000000000000000000000000000002
2222211111110000000001100110011000000001112
2222222222221111111666666666666662266112222
2222222222222222222222222666666666622222222
2222222222222222222222222222222222222222222